# translation for Simplified Chinese

AppGo=AppGo

# UIButton control

sign in=登 录
sign up=注 册
forgot password=忘记密码
register now=立即注册
already have id?=遇到问题？您可以
contact us=联系客服
request code=验证码
reset password=修改密码
modify password=修改密码
run=运行
shop=套餐
me=我的
purchase=购 买
done=关闭
save=保存
international=国外
national=中国
all=全局
global=全局
servers=服务器
connect=请点击按钮开启加速
connected=已连接随机分配节点
disconnect=断开
connecting=连接中
disconnecting=断开中
select server=选择服务器
ok=确定
cancel=取消
close=关闭
pay now=立即订购
term of use=使用条款
twitter=关注我们的Twitter
telegram=加入Telegram讨论群
login/register=登录/注册
delete=删除
start now=立即体验
appgo: on=AppGo: 已连接
turn appgo off=断开AppGo
appgo: off=AppGo: 未连接
turn appgo on=连接AppGo
scan qr code from screen ...=读取QR二维码...
preference=设置
quit=退出AppGo

# UILabel control

country code=国家或地区代码
email account=邮件帐号
nick name=昵 称
phone number=手机号
verification code=验证码
password=修改密码
confirm password=确认密码
stable service and speed, give you a different experience=稳定的服务和速度，给你不一样的体验
current password=密码
new password=新密码
server cluster=服务器集群
attention:=提示：
days=天
attention:=提示：
cluster attention content=到有效期或流量使用完该套餐即停止，请再买新套餐恢复使用。
a coin=A币
level=等级
notifications=动态通知
help=常见问题
feedback=意见反馈
share appgo=分享AppGo
rate appgo=给我们五星好评
about=关于我们
language=多语言
password =修改密码
logout=退出账号
contract our wechat twitter weibo qq group=联系我们微信，微博和QQ群。
english=English
chinese=中文
choose server=选择服务器
server=服务器
server name=服务器名称
delay:%dms=(延时:%dms)
delay:%@=(延时:%@)
acceleration config=加速规则
ads free=拦截广告
network usage=流量使用情况
due time=流量到期时间
package description=套餐特点
package description contents=1.AppGo加速器的流量是加速流量，无法代替运营商的数据流量。\n2.上述加速流量套餐最多支持5台设备同时使用。\n3.国外服务器只加速国外游戏，中国服务器只供海外用户回国加速，请购买应用归属国家的服务器集群，以获得更好的加速体验。
connect time:=连接时间：
scan qrcode=扫描二维码
album=相册
duration: %d days=有效期：%d 天
transfer: %@=流量额度：%@
transfer=流量额度
¥=元 
price=价格
rmb= 元
rmb or= 元或 
alipay=支付宝
applepay=Apple支付
acoin=A币
a coin= A币 
acoin transfer=点我在App内购买A币
select payment method=选择支付方式
help detail=常见问题详细
app version=APPGO V1.4
all rights=copyright©2016-2018 AppGo
particular order=感谢（以下排名不分先后）\nAAA, BBB, CCC, DDD, EEE, FFF\n还有其他1000名参与测试的用户
aboutus=关于AppGo
overtime=超时
feedback description=欢迎使用AppGo客服反馈
request feedback=反馈问题
feedback list=查看反馈
feedback chat=即时交谈
shop plan=加速流量套餐
connected - =已连接 - 
in-app purchase=服务器购买
server: %@=服务器：%@
enter new server name=请输入新服务器名
server name=服务器名称
prompt=提示：
all device install=注册AppGoo账号以便在多台设备上共享买到的流量哟！
127.0.0.1(Example)=127.0.0.1(例子)
purchase comment=推荐登录后购买，可多台设备共享使用加速服务，不注册购买仅支持当前设备使用（而且恢复出厂设置会丢失服务）。
warning=警告
website=官方网站
launch at login=开机启动
allow other devices to connect=允许其他设备连入

# UITextField control

enter email account=请输入您的邮件帐号
enter phone number=请输入您的手机号
enter password=请输入您的密码
enter new password=请输入新密码
enter nick name=请输入您的昵称
enter code=请输入验证码
enter password again=请再次输入密码
enter current password=请输入您的密码
enter new password again=请再次输入新密码
view more=查看通知

# Message

the password must be at least 6 characters.=密码必须至少为6个字符。
wrong account or password.=帐户或密码错误。
please enter email account.=请输入您的邮件帐号。
please enter phone number.=请输入您的手机号。
please enter verification code.=请输入验证码。
please enter current password.=请输入您的密码。
please enter new password.=请输入新密码。
please enter password.=请输入您的密码。
please enter password again.=请再次输入密码。
please enter password correctly.=请正确输入密码。
the email account is invalid format.=邮件帐户格式无效。
sign up succeeded!=您的注册成功了！
please enter nick name.=请输入您的昵称。
failed to switch vpn.=AppGo启动失败，如果您持续遇到该问题，请尝试重启设备，或者重装AppGo。如果依然不能正常工作，请联系service@appgo.hk。
failed to switch vpn with network.=请检查设备网络可用性并重连。
please select payment method.=请选择付款方式。
you must sign in again.=“您必须重新登录。
can't support Apple Pay.=不支持Apple Pay。
please select vpn server.=请选择内购添加的服务器。
failed to parse proxy config=未能解析代理配置。
this device can't support apple payment.=对不起，您的设备不支持Apple Pay。
you have not possible bank card.=您没有可支持的卡片类型。
you can't use sms today, please retry tomorrow again.=今天您不能使用短信,请明天再用一下。
paid successfully.=谢谢，支付成功了。
payment did not succeed.=支付没有成功。
can't connect to the service server.=获取套餐信息超时，请重新连接。
you can't use In-app purchase.=您不能用应用内购买。
failed to parse qr code.=无法识别此二维码。
this server is aleady added.=服务器已经添加了。
this server is added successfully.=服务器添加成功。
do you remove this server?=您想删除这个服务器吗？
can not remove default server.=您不能删除默认服务器。
you purchased successfully.=您的购买成功了。
this server hasn't added.=这服务器没添加了。
failed to pay with In app purchase.=支付失败了。
it paid off successfully.=支付成功了。
waiting for payment.=等待支付中...
choose allow option to authorize=第一次点开关按钮时请选Allow允许AppGo开启加速。
read notificationas and right acceleration=加速规则与服务器不匹配，请查看动态通知选择正确的加速规则。

password has been changed successfully.=修改密码成功了。
failed to change password.=修改密码失败了。
your vpn server is expired now.=您购买的套餐已失效，请重新购买。
alipay failed=支付宝失败了。
could not send email=邮件发送错误
your device could not send e-mail. please check e-mail configuration and try again.=您的设备无法发送电子邮件。 请检查电子邮件的配置,然后再试一次。
these credentials do not match our records.=用户名或密码错误。
appgo feedback=AppGo意见反馈
find appgo icon in your notify tray.=请在任务栏里找到正在运行的AppGo。
change acceleration config after disconnecting service.=请断开连接再切换加速规则。
initializing=初始化...
purchase data plan first=请先购买套餐再选择服务器。

# Service Error Message

can't connect to server.=网络不给力，请稍候重试或切换网路连接。
can't get data from server.=抱歉，不能把数据从服务器上。
new version is available.please update now.=新版本来啦，马上更新吧！

#Appendix

notification=通知
account=个人
settings=设置
scan qr=扫码
usage expire time=流量到期时间
buy now=立即购买
shop item=购买套餐
duration=期限
